10
8
XXXXXXXX
X      X
XXSXX XX
X      X
X XX X X
XXXX   X
X EX X X
X XX XXX
X      X
XXXXXXXX
11
20
XXXXXXXXXXXXXXXXXXXX
X XS  X  XX        X
X X  XX XXX XX XXXXX
X    X  X X X  X   X
X X XX XX XXX X  X X
X X       X X X XX X
X X XXXX X X     XEX
XXX  X      X   X  X
X   X X   X X  X X X
X                  X
XXXXXXXXXXXXXXXXXXXX
11
20
XXXXXXXXXXXXXXXXXXXX
X X   X  XX S      X
X X  XX XXX XX XXXXX
X    X  X X X  X   X
X X XX XX XXX X  X X
X X       X X X XX X
XEX XXXX X X     X X
XXX  X      X   X  X
X   X X   X X  X X X
X                  X
XXXXXXXXXXXXXXXXXXXX
11
20
XXXXXXXXXXXXXXXXXXXX
X XS  X  XX        X
X X  XX XXX XX XXXXX
X    X  X X X  X   X
X X XX XX XXX X  X X
X X       X X X XXXX
X X XXXX X X     XEX
XXX  X      X   X XX
X   X X   X X  X X X
X                  X
XXXXXXXXXXXXXXXXXXXX
10
8
XXXXXXXX
X      X
XXSXX XX
XEX    X
X X  X X
XXXX   X
X  X X X
X XX XXX
X      X
XXXXXXXX
10
8
XXXXXXXX
X      X
XXSXX XX
X      X
X XX X X
X XX   X
X EX X X
X XX XXX
X      X
XXXXXXXX
11
20
XXXXXXXXXXXXXXXXXXXX
X X   X  XX S      X
X X  XX XXX XX XXXXX
X    X  X X X  X   X
X X XX XX XXX X  X X
X X       X X X XX X
XEX XXXX X       X X
XXX  X      X   X  X
X   X X   X X  X X X
X                  X
XXXXXXXXXXXXXXXXXXXX
11
20
XXXXXXXXXXXXXXXXXXXX
X X   X     S      X
X X  XX XXX XX XXXXX
X    X  X X X  X   X
X X XX XX XXX X  X X
X X       X X X XX X
XEX XXXX X       X X
XXX  X      X   X  X
X   X X   X X  X X X
X                  X
XXXXXXXXXXXXXXXXXXXX
11
20
XXXXXXXXXXXXXXXXXXXX
X X   X  XX        X
X X  XX XXX XX XXXXX
XS   X  X X X  X   X
X X XX XX XXX X EX X
X X       X X X XX X
X X XXXX X       X X
XXX  X      X   X  X
X   X X   X X  X X X
X                  X
XXXXXXXXXXXXXXXXXXXX